3OH!3, 100 gecs - LONELY MACHINES
A$AP Ferg feat. Tyga - Dennis Rodman
A. G. Cook - Oh Yeah
AC/DC - Realize
AC/DC - Shot In The Dark
aespa - Black Mamba
Alanis Morissette - Happy Xmas (War Is Over)
Alec Wigdahl - Summer Is Over
Amy Macdonald - Crazy Shade of Blue
Amy Macdonald - Fire
Anabel Englund X MK - Underwater
Anacondaz feat. кис-кис - Сядь мне на лицо
ANIKV - До свидания
Arab Strap - The Turning of Our Bones
Ariana Grande - 34+35
Ariana Grande - positions
ATL - Браслеты
AWOLNATION, Grouplove - Radical
B1A4 - Like a Movie
Bad Bunny x Jhay Cortez - Dakiti
Bastille - survivin'
BBC Radio 2 Allstars - Stop Crying Your Heart Out
Beatsteaks - Glory Box
Bebe Rexha feat. Doja Cat - Baby, I'm Jealous
BENEE - Happen To Me
BENEE - Snail
BENEE, Lily Allen, Flo Milli - Plain
Bent - Friends
Bicep - Apricots
Big Russian Boss & Young P&H – NO HOMO SAPIENS
Billie Eilish - Therefore I Am
Billie Joe Armstrong - Kids in America
Birdy - Island Lights
Blackfield - Under My Skin
BLACKPINK - Lovesick Girls
Bleachers feat. Bruce Springsteen - chinatown
Blue Hawaii - Feelin'
Blue October - Moving on (So Long)
BoA - Better
BOL4 - Dancing Cartoon
Bonobo & Totally Enormous Extinct Dinosaurs - Heartbreak
bridges - Asleep
Bring Me The Horizon - Teardrops 
Britney Spears - Swimming In The Stars
Bruce Springsteen - Letter To You
BTS - Life Goes On
CamelPhat, Lowes - Easier
Carla Bruni - Le petit guépard
Carla Bruni - Quelque chose
Carly Rae Jepsen - It's Not Christmas Till Somebody Cries
Chet Faker - Low
Chloe x Halle - Do It
CHUNG HA & R3HAB - Dream Of You
City Girls feat. Doja Cat - Pussy Talk 
CL - 5 STAR
CNBLUE - Then, Now and Forever
Conan Gray - Heather
Confidence Man - First Class Bitch
Corey Taylor - Culture Head
Dark Tranquillity - Phantom Days
Daughtry - World On Fire
Deftones - Genesis
Deftones - Knife Prty (Purity Ring Remix)
Digitalism - Reality 2
Disciples - I Got You
Dorian Electra - My Agenda (feat. Village People & Pussy Riot)
Draconian - Sorrow of Sophia
Dreamcatcher - No More
DRIPPIN - Nostalgia
Dua Lipa - Love Is Religion (The Blessed Madonna Remix)
Dvne - Of Blade and Carapace
Eddie Thoneick, Parallels - Stay on These Roads
Eels - Anything For Boo
Eels - Baby Let's Make It Real
EJECA - Won't Give Up (feat. Kele)
Elder Brother - I Get So Tired of You
Elektromonteur "Упырь (Revoltmeter Remix)"
Eskimo Callboy - MC Thunder II (Dancing Like a Ninja)
Evanescence - Use My Voice
Evanescence - Yeah Right
EVERGLOW - LA DI DA
First stage - Addiction
Foo Fighters - Shame Shame
Foster The People - Cadillac
Foster The People - Under The Moon
Franky Wah - You Don't Know 
Frayle - Ring of Fire
Freezepop - Anchor to the World Below
fromis_9 - Feel Good (SECRET CODE)
GFRIEND - MAGO
Ghostemane - Lazaretto
girl in red - kate's not here (Day Wave & Lawrence Rothman Remix)
Gorillaz - The Valley of The Pagans (feat. Beck)
GOT7 - Breath
Grouplove - Wildflowers
Gus Dapperton - Medicine
Gwen Stefani - Let Me Reintroduce Myself
Harakiri For The Sky feat. Neige - Sing for the Damage We've Done
HENSY, Клава Кока - Костёр
High Contrast - Rhythm Is Changing (feat. LOWES)
HVME - Goosebumps
I Am Waiting for You Last Summer - Boiling Point
I Prevail & Delaney Jane – Every Time You Leave
Iggy Azalea & Tinashe - Dance Like Nobody's Watching
ILLENIUM - Nightlight
ILLENIUM, Tom DeLonge, Angels & Airwaves - Paper Thin
Inhaler - When It Breaks
Intelligency - Outlaw
Jaga Jazzist - Tomita
Jake Bugg - All I Need
Jamie Cullum - Hang Your Lights (Edit)
Jax Jones & Au/Ra - i miss u
JBJ95 - JASMIN
Jessie Ware - What’s Your Pleasure?
Joan Osborne - Hands Off
Julia Michaels - Lie Like This
KAI - Mmmh
Kate NV - Lu Na
Kelly Lee Owens - Corner of My Sky (ft. John Cale)
Kid Cudi, Skepta, Pop Smoke - Show Out
King Gizzard And The Lizard Wizard - Straws In The Wind
King Princess - Only Time Makes It Human
King Princess - PAIN
Kito, ZHU & Jeremih - Follow
Kodaline - This Must Be Christmas
Kygo & Donna Summer - Hot Stuff
Kylie Minogue - I Love It
Kylie Minogue - Magic
La Femme - Paradigme
Labrinth - No Ordinary 
Lady Gaga - 911
Lana Del Rey - Let Me Love You Like A Woman
LANY - you!
Laura Marling - Alexandra
Lauv & Conan Gray - Fake
LE YOUTH - Unattached
Lee Eun Sang - Mirage
LEE SUHYUN - ALIEN
Lethe - Gamma
Levellers - Generation Fear
LiSA - play the world! (feat.PABLO)
Little Big - Suck My Dick 2020
Little Mix - Not a Pop Song
Local Natives - Lemon (feat. Sharon Van Etten)
London Grammar - Californian Soil
LOONA - Star (Voice English Version)
LOONA - Why Not?
Love Fame Tragedy - Everything Affects Me Now
Love Thy Brother - More Than Friends (feat. Pretty Sister)
LP - How Low Can You Go
Lykke Li - I Will Survive
Machine Gun Kelly & blackbear - my ex's best friend
Machine Gun Kelly ft. Halsey - forget me too
Madeon - The Prince
Mamamoo - WANNA BE MYSELF
Marilyn Manson - DON'T CHASE THE DEAD
MARINA - Man's World
MARRY ME, BELLAMY, ДЖЕДИ - ГРЕШНИЦА
Marshmello & Demi Lovato - OK Not To Be OK
Mat Kearney - Can't Look Back
MATRANG - Взаперти
MATRANG - Мент
Matt Maeson feat. Lana Del Rey - Hallucinogenics
Maximo Park - Baby, Sleep
Maxïmo Park - Child Of The Flatlands
MEDUZA - Paradise ft. Dermot Kennedy
Meg Myers - The Underground
Menen - Гавань
MIKA feat. Michele Bravi - Bella D'Estate
Miley Cyrus feat. Dua Lipa - Prisoner
Miley Cyrus feat. Stevie Nicks - Midnight Sky (Edge of Midnight)
Moby - Rise Up In Love (Moby's Ecstatic Piano Mix)
Molchat Doma -  Дискотека / Discoteque
Molchat Doma - Ne Smeshno
Mome & Ricky Ducati - They Said
Mujuice - Время
MyGrain - Out of This Life
Mylène Farmer - L’âme dans l’eau
Napalm Death - A Bellyful of Salt and Spleen
NCT U - 90's Love
NCT U - Work It
NeuroAxis - Inject Me Now
NEVERLOVE - Без Резинки
Noize MC - Вояджер-1
Nora En Pure - In Your Eyes
Nothing - Say Less
nothing,nowhere. - fake friend
Ocean Jet - Nightmare
OneRepublic - Wild Life
Paloma Faith - Falling Down
Pendulum - Driver
Pendulum - Nothing For Free
Perry Farrell, Groove Armada - Shekina (Groove Armada Terrace 2000 Remix Edit)
Peter Bjorn and John - Season Of Defiance
Philip George & Salena Mastroianni - Same Love
Phoebe Bridgers & Maggie Rogers - Iris
Pixies - Hear Me Out
PIZZA, Елена Темникова - По краям
PLAZMA - Freedom is Finally Mine
polnalyubvi - Кометы
Porridge Radio - 7 Seconds
PUP - Rot
Purity Ring - Better Off Alone
pyrokinesis - Жизнь единственная моя ты
Rea Garvey - Talk To Your Body
Romy - Lifetime
Roxette - Piece Of Cake
Royal Bliss - Medication (feat. Shim)
Royal Blood - Trouble’s Coming
RSAC, Ёлка - Не наговаривай
Run The Jewels - No Save Point
Sabrina Claudio, The Weeknd - Christmas Blues
Sam Fender - Winter Song
Sasha Sloan - Is It Just Me?
Sasha Sloan feat. Charlie Puth - Is It Just Me?
Sea Girls - Accident Waiting To Happen
Sea Girls - This Is The End
Seahaven - Moon
SecondCity & Paul Woolford - All I Want (feat. Andrea Martin)
Secret Machines - Everything Starts
Serge Devant - Third Planet
Sevendust - Blood From A Stone
SEVENTEEN - HOME;RUN
Sewerslvt & Harmful Logic - Tragic Angel
SG Lewis, Robyn & Channel Tres - Impact
Shame - Alphabet
Sia - Courage to Change
Sigala & James Arthur - Lasting Lover
Silverstein - My Disaster (2.0)
Sir Sly, The Naked And Famous - Material Boy
Skillet - You Ain't Ready
Slava Marlow - Снова я напиваюсь
Soilwork - The Nothingness and the Devil
Solardo & Rowetta - Enough
Solomun - Home
Southern Shores - Brisa
SP4K, ЛСП - Атака Кота
SQWOZ BAB & The First Station - АУФ
ssshhhiiittt! - айсберг
STAYC - SO BAD
Steven Wilson - EMINENT SLEAZE
Sting, Zucchero - September
Stray Kids - Back Door
Sub Focus & Wilkinson - Air I Breathe
Sufjan Stevens - America
SUPER JUNIOR-D&E - No Love
System Of A Down - Genocidal Humanoidz
TAEMIN - IDEA
Tash Sultana - Beyond the Pine
Taylor Swift - willow
Tesla Boy, Сабрина - Прогулка
Tessa Violet - Wishful Drinking
The Avalanches - The Divine Chord ft. MGMT, Johnny Marr
The Bouncing Souls - Ghosts on the Boardwalk
THE BOYZ - The Stealer
The Hardkiss - Кобра (feat. MONATIK)
The Neighbourhood - Devil's Advocate
The Ocean - Pleistocene
The Offspring - Christmas (Baby Please Come Home)
The Pretty Reckless - 25
The Raveonettes - SNOWSTORM
The Smashing Pumpkins - Anno Satana
The Smashing Pumpkins - Ramona
The Strokes - The Adults Are Talking
The Weeknd - King Of The Fall
The Weeknd - Save Your Tears
The Weeknd - Too Late
Theory of a Deadman - Strangers (feat. Zero 9:36)
Thy Catafalque - Zapor 2020
Tiësto - The Business
Tokio Hotel feat. VVAVES - Berlin
TOMORROW X TOGETHER - Blue Hour
Tori Amos - Better Angels
Touché Amoré - I'll Be Your Host
Travis - Nina's Song
Travis Scott feat. Young Thug, M.I.A. - FRANCHISE
Troye Sivan - IN A DREAM
TWICE - BETTER
TWICE - I CAN'T STOP ME
VERIVERY - G.B.T.B.
VERKA SERDUCHKA - Sexy
Vicetone & Allie X - Shadow
VLNY - 5 июля
VLNY - Всё в порядке
VOLA - Head Mounted Sideways
WEAPONS OF ANEW - Sick Boy
Weeekly - Zig Zag
Weki Meki - COOL
Wildways - ялюблютебя
Within Temptation - The Purge
You Me At Six - Beautiful Way
Youra - TARAKAN
Ytram - Fire (with Elderbrook)
YUKIKA - Love in TV World
Yumi Zouma - Southwark (Alternate Version)
YUNGBLUD - cotton candy
YUNGBLUD feat. Machine Gun Kelly - acting like that
Zdob și Zdub - Чудо Лилияк
Zivert - Многоточия
алёна швец. - первое свидание
Альбина Сексова - Тик-ток
Би-2 - Бог проклятых
Би-2 и Володя Котляров - Двенадцать
Грязь x Oligarkh - Третье сентября
Дайте танк (!) – Шанс
Дела Поважнее - Пятница
Диктофон, Найк Борзов - Космонавт
Дима Билан - Dreams
Елена Темникова - 2020
Ёлка - Из окон
Иван Дорн - Карнавала.Нет
Луна - Лебединая
Магнитная Аномалия - На литосферных плитах
Мальбэк х Сюзанна - Шазам
МАНУЛА - Вкус соли
Мегаполис — Oh What A Sound
Мегаполис — Три спички
Мейбл - Soft-Girl
Монеточка - Крошка
МС Сенечка - С новым годом, крошка!
МЭЙБИ БЭЙБИ - Бла Бла
Найк Борзов - Больной и злой
Найк Борзов - Горизонтальные люди
Наша Таня - Подруга
нексюша - Современное искусство
Ночные Снайперы - Неторопливая любовь
Пасош, Увула - Искать себя
Порнофильмы & BaseFace - Печаль
Ренарс Кауперс - Мы были там
Свидание - Музыка глаз
Сплин - Джин
Сплин - За семью печатями
Стереополина - Солнечный мальчик
СУЧИЙ ПОТРОХ - соска
Танцы Минус - За шагом шаг
телевидение - sacrament
Три Дня Дождя - Привычка
Три дня дождя, lowlife - Траблы
Трипинадва - Ролямице 2.0
Хадн Дадн - Ветер
Хаски - Бесконечный магазин
Чичерина - Новый мир
